8
8
p...pppp
pp....pp
pp.p...p
pp.pp...
pp.pp...
pp.p...p
pp....pp
p...pppp