9
10
pp.ppp.pp
pp.....pp
p.......p
pp.....pp
pp.....pp
p.......p
.........
.........
.........
pp.....pp