12
9
ppp....pp...
p..........p
...........p
..p........p
...........p
...........p
...........p
p..........p
ppp....pp...