13
9
pppppp.pppppp
pppp.....pppp
ppp.......ppp
pppp.....pppp
p...........p
.............
.............
.............
.............