8
8
pppppppp
ppp..ppp
p......p
........
p......p
p......p
p......p
pppppppp