9
12
p.......p
...p.p.p.
...p.p.p.
...p.p.p.
p.ppppp.p
ppp.p.ppp
ppp.p.ppp
ppp.p.ppp
ppp.p.ppp
ppp.p.ppp
pp..pp.pp
ppp...ppp