13
11
pppppp.pppppp
pp.p.....p.pp
ppp..p.p..ppp
pp.........pp
pp.p.....p.pp
......p......
pp.p.....p.pp
pp.........pp
ppp..p.p..ppp
pp.p.....p.pp
pppppp.pppppp