8
8
p..pp..p
........
........
..p..p..
........
p.p..p.p
ppp..ppp
pp..pppp