14
12
p............p
..............
.........ppp..
........ppp...
........p.....
........p.....
........p.....
......pppppp..
........p.....
........p.....
........p.....
p.......p....p