10
10
pp..ppp..p
p.pp.p.pp.
p.p.....p.
pp..p.p..p
ppp.....pp
pp...p...p
.p........
.p........
.p........
p........p