10
10
pp....pppp
p..p...ppp
....p...pp
.p...p..pp
.....p..pp
....p..ppp
.......p.p
......ppp.
p.........
.........p